#####################
#     #         #   #
##### # ####### # # #
#   #&#       # # # #
#d###e####### # # # #
#   #eec#     #&# # #
### ###d#/##### # # #
#     #dd # #   #e# #
# ######### # ##### #
#           #c#     #
# ######### # ### # #
#   #e    & #  ?  # #
### # ##### ####### #
# # # #  c# #d    ^ #
# # # # # ### #######
#   # / #        *  =
#####################
